11111111111111111111111111111111
100000E0000000000000000000000001
10000000000C00000000100000000001
10000000P00000000000000000000001
11111111111111111111111111111111
