11111111111111111111111
100000000000C00000000E1
10100101001000001100101
10000011010111000111001
10000000000000000000001
10000011010111000111001
100000000000P0000000001
10000000000000000000001
10000011010111000111001
10000000000000000000001
10000000000000000000001
11111111111111111111111