11111111111111111111111
1000000000000C000000001
10100101001000001100101
10100110101010000101101
100000000000000000000C1
10100110101010000101101
100000000000000000000C1
10100110101010000101101
100000000000000000000C1
100000000P00000000000C1
100000000000000000E0001
11111111111111111111111
