11111111111111111111111
100000000000C0000000001
101C0101001000000110011
10000011010111000111001
10000000000000000000001
10000011000101000111001
100000000E00P0000C00001
100C0000000000000000001
10000011010111000111001
10000000000000000000001
10000000000000000000001
11111111111111111111111