11111111111111111111111111111111
100C00000000C0000000000000000001
100C0000000000000000000000000001
10000MM00000000000000000MM000001
1000MMMM000000000000000MMMM00001
10000MM0000000000C000000MM000001
100C0000000000000000000000000001
10000000000000MM0000000000000001
1000000000000MMMM000000000000001
100000000000MMMMMM00000000000001
1000000000000MMMM000000000000001
1000000000E000MM0000000000000001
1000MM0000C000000000000000MM0C01
100MMMM000000000000000000MMMM001
1000MM0000P000000000000000MM0001
1C000000C00000000000000000000001
11111111111111111111111111111111
