11111111111111111111111
100000000000C00000000E1
10100101001000001100101
100P0110101010000101101
10000000000000000000001
11111111111111111111111