1111111111111111111111111111111111
1E0000000000000C000000000000000001
1010010100100000101001000000010101
1010010010101010001001010000010101
1P000000000000000000000000000000C1
1111111111111111111111111111111111
