11111111111111111111111
100000000000C00000000E1
10100101001000001100101
10100110101010000101101
100P0000000000000000001
11111111111111111111111