11111111111111111111111
100000B00000C00000000E1
101C0101001000001100101
10100110101000000101101
100P0000000000000000001
10000110101010000101101
100000B000000000B000001
11111111111111111111111