11111111111111111111111
10000G0000000C0J0000001
10100101001000001100101
10100110101010000101101
10000000000Z0000000L001
101001101010100000C1101
10000000000001000000011
1010011010100C100101101
10000000M000000WWW00001
100000000P0000000011001
100000000000000001E0001
11111111111111111111111
