111111111111111111111111111111
1E00000000000C0000000000000001
101001010010000011000000010101
101001101010100001010000010101
1P00000000000000000000000000C1
101001101010100001010000010101
1P00000000000000000000000000C1
101001101010100001010000010101
1P00000000000000000000000000C1
111111111111111111111111111111
