111111111111111111111111111111111111111111111
10000000000000B000000E00000000B00000000000001
1000110BB011000000000000000000000110BB0110001
1000110000110000M11M00000M11M0000110000110001
100011C00C110000M11M00000M11M000011C00C110001
100011MMMM110000M11MMMMMMM11M000011MMMM110001
100011MMMM110000M11111111111M000011MMMM110001
100011C00C110000M11111111111M000011C00C110001
1M00110000110000M11MMMMMMM11M00001100001100M1
1M00110BB0110000M11M00000M11M0000110BB01100M1
1M00000000000000M11M00000M11M00000000000000M1
1M00000000000000000000000000000000000000000M1
1M0011111111000B000CCCCCCC000B0001111111100M1
1M00111111110000000CCCCCCC00000001111111100M1
1M00000000000000000000000000000000000000000M1
1M00000000000000M11M00000M11M00000000000000M1
1M00110BB0110000M11M00000M11M0000110BB01100M1
1M00110000110000M11MMMMMMM11M00001100001100M1
1M0011C00C110000M11111111111M000011C00C1100M1
100011MMMM110000M11111111111M000011MMMM110001
100011MMMM110000M11MMMMMMM11M000011MMMM110001
100011C00C110000M11M00000M11M000011C00C110001
1000110000110000M11M00000M11M0000110000110001
1000110BB011000000000000000000000110BB0110001
10000000000000B00000P000000000B00000000000001
111111111111111111111111111111111111111111111