111111111111111111111111111111111111
10001000011100001C010000111000010E01
10C010C0000000001001000000000C010C01
1000100010C0000010010000C00100010001
100010001000000010010000000100010001
100010001000100010010001000100010001
100010001000100000000001000100010001
110010001000100000000001000100010011
110000C00000100C1111000100000C000011
110000C00000100011110C0100000C000011
110010001000100000000001000100010011
100010001000100000000001000100010001
10C010001000100000010001000100010001
100010001C00100000010001000100010001
100010001000000010010000000100010001
100010001000C00010010C00000000010001
100010C0000000001001000000000C010001
10P010000111000010C1000011100001C001
111111111111111111111111111111111111