111111111111111111111111111111111111
100010000111000010010000111000010E01
100010000000000010010000000000010001
100010001000000010010000000100010001
1000100010000000100100C0000100010001
100010001000100010010001000100010001
100010001000100000000001000100010001
110010001000100CCCCCC001000100010011
110000C00000100C1111C001000000000011
110000000000100C1111C001000000000011
110010001000100CCCCCC001000100010011
100010001000100000000001000100010001
100010001000100000010001000100010001
10001000100010000C010001000100C10001
100010001000000010010000000100010001
100010001000000010010000000000010001
100010000000000010010000000000010001
10P010000111000010010000111000010001
111111111111111111111111111111111111