11111111111111111111111
100000B00000C00000001E1
10100101001000001100101
101001101010000001011M1
100P0000000000000000001
10000111101010000101101
100000B100000000B000001
11111111111111111111111