11111111111111111111111
100000B0000MCM0000001E1
10100101001MMM001100101
10100110101000000101101
100P0000000000000000001
10000101001010000101101
100001C100000000B000001
11111111111111111111111