1111111111
1P00000001
1000CC0001
1000CC0001
1000000001
1111111111