1111111111
1P000000E1
10RC000001
1000000001
1F0000R001
1111111111