11111111111111111111111
100000B0000010MMMMM00E1
10100101001000001100101
101001101010000001C1111
100000000000000000000P1
10000111101010000101101
100000B100000000B000001
11111111111111011111111