1111111111
10000000E1
1000CC0001
1000CC0001
100PP00001
1111111111