11111100000000111111111
100000B00000C0MMMMM01E1
10100101001000001100101
10100110101000000101101
100P0000000000000000001
10000111101010000101101
100000B100000000B000001
01111111111111111111111