11111111111111111111111
100100B00100C00100000E1
10010000010000010001111
100100C00100000100C0001
10000000000000000000001
10000100000010000010001
10P001B000001000B010001
11111111111111111111111