1111111111
1P0C0000E1
1111111111