1111111111
1CCPE11111
1111111111